0000250000000000000000000000000
0103100000000000000000000000000
2221310000000000000000000000000
3323532321000000000000000000000
5976557341000000000000000000000
xx86973220000000000000000000000
xxx99x6200000000000000000000000
xxxxxxx611100000000000000000000
xxxxxxx950020000000000000000000
xxxxxx8942400000000000000000000
xxxxxx9732120000000000000000000
xxxxxxx431300000000000000000000
xxxxxxx811000000000000000000000
xxxxxx8520000000000000000000000
7xx8525420000000000000000000000
878x610221000000000000000000000
6242311001000000000000000000000
7320110000000000000000000000000
6510220000000000000000000000000
6311000000000000000000000000000
6620000000000000000000000000000
